8 chunks in world
+ + + + + $ + + + + + + 
$ . . + + . . + + . . + 
+ . . + + . . + + # . + 
+ + + + + + + + + + + + 
+ + + + $ + + + + + + + 
+ . . + + . . + + . . + 
$ . . + + . . + + . . + 
+ + + + + + + + + $ + + 
+ + + + + + + + 
+ . . + + # . + 
+ . . + + . . + 
$ + + + + + + + 
